1111111111111
10000000001P1
1C00000000101
1000000E00C01
1111111111111