1111111111111111111111111111111111
1E1000000000000C00010C100000000001
1010010100100000100001100000010101
1000010010111110001001000000010111
1P1000000C01C0000000000000000000C1
1111111111111111111111111111111111